# Syntax Highlighting for RadiaCode Library

# Classes (KEYWORD1)
RadiaCode	KEYWORD1
BytesBuffer	KEYWORD1
DataItem	KEYWORD1
RealTimeData	KEYWORD1
RawData	KEYWORD1
DoseRateDB	KEYWORD1
RareData	KEYWORD1
Event	KEYWORD1
Spectrum	KEYWORD1
AlarmLimits	KEYWORD1
BluetoothTransport	KEYWORD1
RadiaCodeTransport	KEYWORD1

# Methods and Functions (KEYWORD2)
spectrumChannelToEnergy	KEYWORD2
getDriverVersion	KEYWORD2
execute	KEYWORD2
readRequest	KEYWORD2
writeRequest	KEYWORD2
batchReadVSFRs	KEYWORD2
status	KEYWORD2
setLocalTime	KEYWORD2
fwSignature	KEYWORD2
fwVersion	KEYWORD2
hwSerialNumber	KEYWORD2
configuration	KEYWORD2
textMessage	KEYWORD2
serialNumber	KEYWORD2
commands	KEYWORD2
deviceTime	KEYWORD2
dataBuf	KEYWORD2
spectrum	KEYWORD2
spectrumAccum	KEYWORD2
doseReset	KEYWORD2
spectrumReset	KEYWORD2
energyCalib	KEYWORD2
setEnergyCalib	KEYWORD2
setLanguage	KEYWORD2
setDeviceOn	KEYWORD2
setSoundOn	KEYWORD2
setVibroOn	KEYWORD2
setSoundCtrl	KEYWORD2
setVibroCtrl	KEYWORD2
setDisplayOffTime	KEYWORD2
setDisplayBrightness	KEYWORD2
setDisplayContrast	KEYWORD2
setDisplayDirection	KEYWORD2
getAlarmLimits	KEYWORD2
setAlarmLimits	KEYWORD2
getTemperature	KEYWORD2
setDoseRateUnits	KEYWORD2
setCountRateUnits	KEYWORD2
setTemperatureUnits	KEYWORD2
setAlarmSignalMode	KEYWORD2
getSpectrumFormatVersion	KEYWORD2
setCountRateAlarmLimits	KEYWORD2
setDoseRateAlarmLimits	KEYWORD2
setDoseAlarmLimits	KEYWORD2
clear	KEYWORD2
size	KEYWORD2
empty	KEYWORD2
push_back	KEYWORD2
at	KEYWORD2
decodeSpectrum	KEYWORD2
decodeDataBuf	KEYWORD2

# Enums (KEYWORD3)
VS	KEYWORD3
VSFR	KEYWORD3
CTRL	KEYWORD3
COMMAND	KEYWORD3
EventId	KEYWORD3
DisplayDirection	KEYWORD3
DEV_CTRL	KEYWORD3
DISPLAY_CTRL	KEYWORD3
AlarmSignalMode	KEYWORD3
MeasurementUnits	KEYWORD3
CountRateUnits	KEYWORD3
TemperatureUnits	KEYWORD3
DataItemType	KEYWORD3

# Constants (LITERAL1)
AUTO	LITERAL1
RIGHT	LITERAL1
LEFT	LITERAL1
BUTTONS	LITERAL1
CLICKS	LITERAL1
DOSE_RATE_ALARM_1	LITERAL1
DOSE_RATE_ALARM_2	LITERAL1
DOSE_RATE_OUT_OF_SCALE	LITERAL1
DOSE_ALARM_1	LITERAL1
DOSE_ALARM_2	LITERAL1
DOSE_OUT_OF_SCALE	LITERAL1
CONNECTION	LITERAL1
POWER	LITERAL1
COUNT_RATE_ALARM_1	LITERAL1
COUNT_RATE_ALARM_2	LITERAL1
COUNT_RATE_OUT_OF_SCALE	LITERAL1
CONTINUOUSLY	LITERAL1
ONCE	LITERAL1
ROENTGEN	LITERAL1
SIEVERT	LITERAL1
CPS	LITERAL1
CPM	LITERAL1
CELSIUS	LITERAL1
FAHRENHEIT	LITERAL1
TYPE_UNKNOWN	LITERAL1
TYPE_REAL_TIME_DATA	LITERAL1
TYPE_RAW_DATA	LITERAL1
TYPE_DOSE_RATE_DB	LITERAL1
TYPE_RARE_DATA	LITERAL1
DRIVER_VERSION_MAJOR	LITERAL1
DRIVER_VERSION_MINOR	LITERAL1
DRIVER_VERSION_PATCH	LITERAL1
